000000000000000000YY000000O0000G000P00000000000000B0000Y000000000000000O000000Y00000000O0000P000L
000G000R0000000000000BB00B00000G000000Y0000000O0Y0000000B000000Y00P0000O00000Y000000000G0000O000G
00R00000R00000BG00OO0000Y0P0000G000P0000000RGB00000R00000G0000B000P00Y000R0000Y000GRG00Y00R00000G
000B00000R000B0000000GG00G00000G000000Y0000000O0G000000000O00R00000G0Y0000B00000B0000B00P00B0000G
000000000000B00000PP000000R0000G000P00000000000000B000000000P000000G0000000P0000B00000P000000Y00G